.
....#...............#.#..###.##
.#..#....###..............##...
....###......#....#.#...#.##..#
.......#........#..###...##....
.....#..#......#..#..##..#...#.
....#..........#....#...#......
............###...#............
##......#.....#......#.....##..
........#.........##..#.#...##.
....#.#..#.#...#........#..#...
.#.....#.#......#....#..#..#..#
#.##..##......#.....##...#..#..
#........#..##...###....##.....
......#.#..##...#.#.....#......
##.......#..#.........#...#....
.....##.........#....#.#.###.#.
..##...........#.#.#.#.....#.#.
....#...............#......#.#.
#.#..#....#.....#.....##...#..#
#......#..............#.#.##...
......###.....#...#........###.
####...#.....#...#....#........
.......#...#....##...#.........
.####..##............#.........
#.#...#...#....#...#.#......#..
..#..#.....#.......#...#.#...##
.#.........#...#......##.#...#.
.#.#...#...#.....#.#........#.#
.#.....###....###..##.#..##.#..
.....##....#......#..#...#...#.
#...##....#.......#.....##.##..
#...#.....#.#...........#..###.
##.#........###...........###.#
#...#.#........#.#.....#.......
..................#..#.........
.....#.#..#.#......#..#.....##.
.#.#.......#..##........#..##.#
.#.#..#.#...#.......#.#.#..#...
...#......#....#....##.#..#....
......#.......##....##..#.....#
...#.##...##...............#..#
.###....#.#.....##..#.......#.#
#....#..........#...........#.#
...#...............#.#..#....#.
.....#..##..........#..###.....
.....####.....#.#.......#...#..
#.............#...#.......##...
.#....##.......#.#......#.#.##.
.#..#.......#..##...#...#......
#.......#..#..#..#.....#.......
##...#.#.#...........#....#....
.......#..#.#..............#.#.
.....#.......#.......#.#.#.....
....##.##.....#......#.......#.
#...#..#.#....###....##...#.#.#
#..#......#........#.#.#.....#.
###..##..#......#.....#.......#
..##....#.#.#......#..##...#...
.....#..#....#...#.#...#...#...
.....#.#..###.#..#...##......#.
#.#..#....#..#.....#.#...#.#...
.#..#....#.......#..#.......#..
#.........#..#..#.........##..#
..##.##..#..#...##.............
.....###...#..#...##.#..#......
#.##.....##..............#.....
.......#.##.#.##...#.#.......##
...#.#.##...#......#...........
##.#........#.....##.....#.....
.#.....#.............#......#..
....#..##..#..#....#..#.#......
.#.....#....##..##..#...##.....
.##........#.#.#.#..........#.#
...#.#.#..#....#...#..###.##...
.#....#....#.#.#.#....#..#.....
#.#.......#..#..#...........#.#
.....#.....##..#....##.........
....#.##..............#........
.................#....#.......#
...................###...#...#.
...#.#..#..##..##....#.....#...
#...#..........................
.......#..#..#.#..#.....#......
..##.#..#......#...#.##..##..#.
.##.........#.#...........#....
...#...#..##.#......#..#..#....
.....#.#....#...#............#.
.##..#.....##....#...#.........
#......##...#...#............#.
.....#.##...#.#....##..........
.............#.......#.#.......
##....#.#........#....#..##....
....#...##.#....##..#.....#.#..
...##..#....##......#...#......
.####.#..#..#.#...#.#.#....#...
.#........#.##....#.#....#.....
.........#....##..#..#.........
....##...#....##.............#.
....#..##.#....#.#..#...##.....
.....##...#..#....#......#.#...
..........#.......#.##..#.##..#
.......#.........#...#.##......
....##.#.......#...............
....#.......#..##.......##.#.##
#.#..#.#....#.#.........###...#
.#.##.....##..##...........#.#.
...#....##........##...#...#...
.#.##....#.#...#.#..#..#...#...
#....#.##...#.#..#....#.....#..
#..#...#........#...........#..
...........#.......#......#..#.
....##...#......##.....#......#
.#.##.#.#.............#....##..
.#...#...##.#.#........#..##.#.
.#.#........#.#...#..#........#
.###.#.#...#..#..#.#....#..#...
..##..##....#.#............#...
#..........#........#..#.#.#...
.#...#..#..#.#.....#.....#....#
#.....#.#.#.....####.......#...
...#.#........#.#.###...#.....#
.....#.....##....#....#..##...#
..#....###.##.#..#..#....#...#.
.....#.....#...........#.#.###.
.....#......###...#.#...##.....
...........###..#...#....#.#..#
...#..###.....#....#.#...#.....
.......#...#..#..##....#.#.#...
...#..####.###........#.....#..
..#......###..#..#.##..........
....#....##..##..##.......###..
...#.......#..#.#....##........
.#.#.....#.#.#..........#..#..#
.##....##....##...........##.##
........#......#.##....##...#.#
..#.#.....#..#....#..........#.
...........#...............#...
.....####.....#.....###.#..#...
..........####..##.##.#....#...
...#.#.#......#....#..#.#......
.#.#......###.....#....#.......
..#..#..#.......#..#...#.....#.
...#............#......##...###
......#.............#..#..###..
.#.#......#..##.#..#..#.#...#.#
.#.....#.......#..#...........#
..#.###.#..#...#.##..#.##......
....#.#........#..#.#...#.#.##.
.#..##.#..#.#.#...##..#.#......
.......#..#..#..#.....#.#.#..#.
.##.###..##.....#.##..#........
...##..............#.#.##....#.
##....#...#...........#........
..#........#.#.##..#.#...#..#..
.......#.......##.#..#....#.#..
.......#....##..#.#.#..#....#..
..........#....#..#..#....#....
........#.....#.#.....##.......
........##.###.........#.#.#...
###......####...#.#........#...
......#........#......#.....#..
##..#.##..##.###..#........##..
.#..#...#............##.##..#..
...........#..#.#..............
.##.#.#....#...............#..#
.........##.................#..
#............##..##.........##.
##........#.........#..##.#...#
........#.....#..#.........#.##
....#......#.....##.##.........
.#.#.....#.#..#..##....#....#..
.###...#..##....##.....#.#..##.
.#....#.#.......#..#..#...###..
..#.#......#.#..#.....###.....#
#....#..#...#.....#.......#.##.
.#.......##.#.#...#......#.....
###....#.#......#....#.#...##..
...#....####.......##.....#..#.
.#.................#.......##.#
...#.###..........#..##......#.
.....##.#..............##..#...
#.....#..#..........#..#.......
..#...#.#.#.......##.#.....#...
#........#.#........#.#.....#..
#.....#...##....##..##........#
.#.##..#...#....#........#..#..
#..#.....#....#...##......#....
...#...#...#.#.#....##....#.#.#
......#...............#.....#..
.......#.#..#..##.#.....#......
...........##......#...#.......
....##..##.....#.#...#.........
......##..###.......#....#.##..
......#..#.##....#..###..#.....
.....#.........#........##.....
.....####..................#...
.#.#...##................#.....
.#..#...#...#.....#.##..#..#...
.#................#...###....#.
...#....#...........#...#....#.
.......#....##...............#.
.#.#.##..##.......#....#....###
......#.#....#...#..#..........
....#.##.#.#...##.#.#......#...
##....#...##.....#..#.###.#....
.......#......#.........#.#...#
.##.#...........##.........#.#.
##..##.....#...#..#.#...#....#.
#..##......###........#...#....
.....#.#.......#...#..##....##.
.....#.#..#.....#.......#..##..
...#..#..............#.#.......
.#.#...###......###............
.....#.....#...#.###...........
.......#..................#...#
#....#...#...#....#....#.#....#
....#..#............#.#........
#....#..........#.#.#..#..#....
.......#....#......#....#......
.##.#.#...#...#...##...........
.........###.#..#..............
...#........##....#....#....###
....##..#.......#.#...#.#..#.#.
.....##....#..##.........#.....
........##..#........#.........
...........#..#.##..##...#.....
.........#.#..####..#...#.##.##
##..#.#.....##.....#.........#.
..#...#...#....#.#....#.....#.#
.###.#....#.#......#....#......
.##.....#....#.......#.#..#.##.
#..#..##.....#....#...##.....#.
...#.........####.........##..#
..#.....#....###.#.#...#..#....
.........#....#..#.#.........#.
.....###.##..#...#.....#..#..#.
....#......#..#.#...#.....#....
.......#...#..#....#.......#.#.
.#....#............#....####...
#..##..##....#.....#...#.....#.
...#...##...#.#....#...........
.......#####.....#..###.#..#...
.....#.....#.#....#.........#..
.###.#..#...##.##.#.#..#..#....
.#..#.##..#......#..........##.
##....#....#.........###..#....
..#.............#.......#.#....
..#.....#..##...#...###..#.##..
##...##...#.#....#..#..........
...............#.....#.......#.
....#.#......##.#......#...#.#.
.........#.............#.#.....
...#.#.........................
..#..#....##..#...###.##.......
...##.#...##..#.#.##.#...#.##..
.##....#....#.......#.....##..#
.#...............#..#...#......
...##.....##.###....#.....#...#
...#.....#...####....##....#..#
..#.#.###..##.....#........#...
.....##.##..#..#.........##....
........##.....#..........#.##.
..##.#....####..#...........#..
##....#..#..#.#.##.....#...##..
...#...#......#..#.#....#......
##.....##.......##.##....#.....
.........#...##...........#....
.###.#..#....##...#.....#.....#
...#..........#.###..##...#.##.
...#..#....#.#.#.......###.....
....#..#.#.....##...#.#.#.#....
.......##..#...##..##.#....#...
.##..........#.#.#.....#.....#.
#....#......##...#..##.#..#..#.
.#...#.....###..#......#.....#.
.#..#.###.......#.##....###....
#....#....#....#....#..#.##....
..#..#.....#.....#....###.....#
##.###..#...##.......#.#.......
#...##......##....#.#...#....#.
..##.#.#....#...#.....##.......
.#....#..#...#...##..##........
###......#.##....#.#..##.......
...#.....##.#.........#..#.....
.......#.#....#.....##......#..
#..#..............##.#........#
....#.#....#..#.#...##.........
..........#..........#.........
.#.....#.....#.##....#.##..#..#
.......#.......#.#.#.##....#...
..#...........#....#.......##..
..#.#.#.#...##..#.#.#..#...#.#.
..#..#..........#...##....#....
....##.#....#.............#....
.##...##..........#.#..#...#...
#..#..#.##..........##.........
............#.......#..#.....##
....#......#........#..#.##....
#.#......#.#...#.....#.........
..#.....#..#..........#.....#..
.#..#.#.#.##...#..#.#.........#
#...##....#..##..#...#.#.##....
#..##.##.#.##.......#.......#..
#.#.......#........#.##....#.#.
....#..##....##..##......#..##.
#.....#....#.#........####.....
......#...#...###..#...........
.##.#.##...##................##
..##.#.....#.#..#......#.#.....
......#...#........#.....#.##..
#..#.#..#.....#.#..#..##..#.#..
...#.........#.#.#.##...#......
...#..##....#..#.#....#.###.#..
........###................##.#
##...........#......##.##.....#
.#.#.#....#....#....#..........
#.....#........................
....#.....#...#......#.........
....#.#..#..............#......
##.........#..#....#.......#...
.###....#..#.#.####.........#..
..#.#....#.....###..#..........
..........#................#.##